########################
########################
########################
###########....T########
###########.###.########
###...#####.###.########
###K..T.c...##...#######
###...#####.##pbp#######
###########.############
###########M############
######m........M....s###
###########.############
###########M############
###########p############
##########...###########
##########.B.###########
########################
########################
########################