########################
########################
########################
############b#####.K.###
############.#####...###
############...T.....###
###B..######.###########
#####m######.###########
#####.######p###########
#####p######.###########
#####.######...T...c####
#####..M#######.########
#######...#####.########
#########.#####.########
#########s.....M...p####
########################
########################
########################