#########################
#########################
#########################
####ppp#p###.###.###.####
####pap#.###.###p###.####
####ppp#.###.###.###.####
########.###.###.###.####
########M###M###M###H####
###KsmHbTc.H.p...Hp..B###
########M###M###M###H####
########.###.###.###.####
########.###.###.###.####
########p###p#######.####
####################.####
#######.wp##########H####
#######ppp#####sHp...####
#########################
#########################
#########################


